NO texture/north.xmp
SO ./path_to_the_south_texture
WE ./path_to_the_west_texture
EA ./path_to_the_east_texture

F 220, 10 ,225
C 225,30,0


11111111  111
111000011011111
11N01111111111
111111 1111  
1111   1111111