SO textures/south.xpm
NO textures/north.xpm
WE textures/west.xpm
EA textures/east.xpm

F 100,100,0
C 250,30,0

11111
1   1
1   1
1   1
1   1
1   1
1   1
1   1
1   1
11111
