
NO ./path_to_the_north_texture
SO ./path_to_the_south_texture
WE ./path_to_the_west_texture
EA ./path_to_the_east_texture

F 220, 10 ,225
C 225,30,0




1111111111111
1100000000001
1111111111111 0011111111111111
             110000000000011
            1111000000000001
 1111111111110000000000011111
1110000000000000N00000001111
111111111111111111111111111