NO ./path_to_the_north_texture
SO ./path_to_the_south_texture
WE ./path_to_the_west_texture
EA ./path_to_the_east_texture

F 100,100,0
C 250,30,0

1111111111111111111111111
1000000000110000000000001
1011000001110000000000001
1001000000000000000000001
1111111110110000111100001
10000000001100001 1110111111111111
11110111111111011 10000001011
11110111111111011111010010001
11000000110101011100000010001
10000000000000001100000010001
100000000000000011111100100011
1100000111010101111 1011110N0111
1111011111101011011 1101001111
111111 111111111111 111111111
1111111111111111111111111111
