NO ./path_to_the_north_texture
SO ./path_to_the_south_texture
WE ./path_to_the_west_texture
EA ./path_to_the_east_texture

F 100,100,0
C 250,30,0

111 111111111 1111111111111
        11111110000011
   11111111111100000111
11111000000N0000000011 1  
1 111111111111111111111
