NO ./path_to_the_north_texture
SO ./path_to_the_south_texture
WE ./path_to_the_west_texture
EA ./path_to_the_east_texture

F 100,100,0
C 250,30,0

1111 11111111 1111111111111
        11111110000011
   111111111111000001111
1111100N00000000000001 1
1 1111111111111111111111
