SO textures/south.xpm
NO textures/north.xpm
WE textures/west.xpm
EA textures/east.xpm

F 100,100,0
C 250,30,0

         111111111  111111111111111111
         100000001  100000000000000001
         10110000111100000001111111111
11111111110000000000000000011111
10000000111100010000N00001001
100000001  100110101110000001
10000000111110000001 10100001
11111111111111111111 11111111
