NO ./path_to_the_north_texture
SO ./path_to_the_south_texture
WE ./path_to_the_west_texture
EA ./path_to_the_east_texture

F 100,100,0
C 250,30,0


1111111111
1       11
1        1
1        1
1        1
1        1
1111111111
11111N0001
1111111111