SO textures/south.xpm
NO textures/north.xpm
WE textures/west.xpm
EA textures/east.xpm

F 100,100,0
C 250,30,0

1111 11111111 1111111111111
        11111110000011
   111111111111000001111
1111100N00000000000001 1   1111
1 1111111111111111111111    111