SO textures/south.xpm
NO textures/north.xpm
WE textures/west.xpm
EA textures/east.xpm

F 220, 10 ,225
C 225,30,0

1 111111111
111001001
 1010011111
1111111   11
1100N011111   
100011111  
11111  1111
11 1111111111
